NO      ./cobblestone.xpm 
SO      ./dirt.xpm
WE      ./diamond_ore.xpm
EA      ./bricks.xpm



F 69,50,49 
C 17,134,250    



1111111
1000001
1010101
1000001
1000001
100N001
1111111
