NO      ./test1      
SO      ./test2
WE      ./test3
EA      ./test4



F 69,50,49 
C 17,134,250    



11111
10001
10N01
10001
11111