NO      ./test1      
SO      ./test2
WE      ./test3
EA      ./test4



F 69,50,49 
C 00,100,232        



11111
10001
10001
1N001
11111