NO      ./assets/orangewall.xpm
SO      ./assets/orangewall.xpm
WE      ./assets/greenwall.xpm
EA      ./assets/purpelwall.xpm





F 200,200,200
C 30,30,30


11111111111111111111
1S000000000000000001
10111111111111011101
10100000000001000001
10101111111011110101
10101000001000000101
10101011101011110101
10100010001000000101
10111110101111110101
10000000100000000101
10111010111101110101
10100000100000000101
10101110111111110101
10100000100000000101
10101110101111110101
10101010101000000101
10100010001011110101
10111110100010000101
10000000111110110101
11111111111111111111

