NO      ./assets/minecraft/blackstone.xpm
SO      ./assets/minecraft/bricks.xpm
WE      ./assets/minecraft/diamond_ore.xpm
EA      ./assets/minecraft/glowstone.xpm



F 241,176,0
C 135,206,235  


        1111111111111111111111111        1111111111111111111111111         
        1000000000110000000000001        100000001100000100000011
        1011000001110000000000001        100000N001110000010000001 
111111111111111111111111111111111111111111111111111111111111111111