NO      ./assets/minecraft/diamond_ore.xpm
SO      ./assets/minecraft/bricks.xpm
WE      ./assets/minecraft/blackstone.xpm
EA      ./assets/minecraft/glowstone.xpm



F 241,176,0
C 135,206,235  


1111111111111111111111111        1111111111111111111111111         
1000000000110000000000001        1000000011000001000000011
10110000011100000000000011111111111000000001110000010000001
10000000001000000000000000000000000000100000000000000001001 
10000000000000100000000000000000000000100000000000000000001 
100000000000000000000000010000000O0000000000000000000000001 
10000000000000000000000000000000000000000000000000000000001
11100000000011111111111111111000000000000001111111111111111 
10000000000000000000011110000000000000000000000001111111111
11110000000000000000000000000000000000000000001111111111111
11111111100000000000011110000000000000000000000010000000001
11111100000000000000001110000000000000011000000000000000001
11110000000000000000000100000000000000111000000000000000001
11111111111111110000000000000010000011111111000000000111111
11111111111111111111111111111111111111111111111111111111111