NO      ./assets/black.xpm
SO      ./assets/black.xpm
WE      ./assets/black.xpm
EA      ./assets/black.xpm
DO      ./assets/black.xpm
DC      ./assets/black.xpm



F 255,255,255
C 255,255,255    

11111
10001
10001
10001
11211
10001
10001
10N01
10001
10001