NO      ./assets/black.xpm
SO      ./assets/black.xpm
WE      ./assets/black.xpm
EA      ./assets/black.xpm



F 255,255,255
C 255,255,255    


11111111
110000011
110101001111
1000N0000001
1100000001111
11111111111
