NO      ./assets/titou42.xpm
SO      ./assets/titou.xpm
WE      ./assets/titou.xpm
EA      ./assets/titou.xpm



F 142,142,142
C 35,35,35



    1111111111111111111111111         
   10000000000000000000001      
  1000000000000001000000001      
 1000000000000000000000001
1000000000000000000000001
 1000000000001000000000001
  1000000000000000000000001
   1000000000N00000000000001
  1000000000000000000000001
 1000000000000000000000001
1111111111111111111111111
